assets/bg-0.png

BBBBBBBBBBBBBBBBBBBBBBBBBBBBBBBBBBBBBBBBBBBBBBBBBBBBBBBBBBBBBBBBBBBBBBBBBBBBBBBBBBBBBBBBBBBBBBBBBBBBBBBBBBBBBBBBBBBBBBBB
B##..........[].......................................................................................................BB
B##..........[].......................................................................................................BB
B##..........[].......................................................................................................BB
B##..........[].......................................................................................................BB
B##..........[].......................................................................................................BB
B##..........[].......................................................................................................BB
B##..........[].......................................................................................................BB
B##..........[].......................................................................................................BB
B##..........[].......................................................................................................BB
B##..........[].......................................................................................................BB
B##..........[].......................................................................................................BB
B##..........[].......................................................................................................BB
B##..........[].......................................................................................................BB
B##..........[].......................................................................................................BB
B##..........[].......................................................................................................BB
B##..........[].......................................................................................................BB
B##..........[].......................BBBB............................................................................BB
B##..........<>.......................................................................................................BB
B##..........H........................................................................................................BB
B##...BB..............................................................................................................BB
B##......................................CCM.............."..1..."....................................................BB
B##........................................................BBBBBB...............{}....................................BB
B##..............1.......BBB...........2.......B................................[]....................................BB
B##...LGR..............BBBBBBBBB..............BBBB..............................[]....................................BB
BGGGGGIIIGGGGGGGGGGGGGGGGGGGGGGGGGGGGGGGGGGGGGGGGGGGGGGGGGGGGGGGGGGGGGGGGGGGGGGGGGGGGGGGGGGGGGGGGGGGGGGGGGGGGGGGGGGGGGBB
BIIIIIIIIIIIIIIIIIIIIIIIIIIIIIIIIIIIIIIIIIIIIIIIIIIIIIIIIIIIIIIIIIIIIIIIIIIIIIIIIIIIIIIIIIIIIIIIIIIIIIIIIIIIIIIIIIIIIIBB
BIIIIIIIIIIIIIIIIIIIIIIIIIIIIIIIIIIIIIIIIIIIIIIIIIIIIIIIIIIIIIIIIIIIIIIIIIIIIIIIIIIIIIIIIIIIIIIIIIIIIIIIIIIIIIIIIIIIIIBB
