BBBBBBBBBBBBBBBBBBBBBBBBBBBBBBBBBBBBBBBBBBBBBBBBBBBBBBB
B....................................................BB
B....................................................BB
B....................................................BB
B....................................................BB
B....................................................BB
B....................................................BB
B....................................................BB
B....................................................BB
B....................................................BB
B....................................................BB
B....................................................BB
B....................................................BB
B....................................................BB
B....................................................BB
B....................................................BB
B....................................................BB
B....................................................BB
B.....BB.............................................BB
B............H...MM..................................BB
B....................................................BB
B........................BBB...................B.....BB
B.....LGR..............BBBBBBBBB..............BBBB...BB
BGGGGGIIIGGGGGGGGGGGGGGGGGGGGGGGGGGGGGGGGGGGGGGGGGGGGBB
BIIIIIIIIIIIIIIIIIIIIIIIIIIIIIIIIIIIIIIIIIIIIIIIIIIIIBB
BIIIIIIIIIIIIIIIIIIIIIIIIIIIIIIIIIIIIIIIIIIIIIIIIIIIIBB
