BBBBBBBBBBBBBBBBBBBBBBBBBBBBBBBBBBBBBBBBBBBBBBBBBBBBBBBBBBBBBBBBBBBBBBBBBBBBBBBB
B##...........................................................................BB
B##...........................................................................BB
B##...........................................................................BB
B##...........................................................................BB
B##...........................................................................BB
B##...........................................................................BB
B##...........................................................................BB
B##...........................................................................BB
B##...........................................................................BB
B##...........................................................................BB
B##...........................................................................BB
B##...........................................................................BB
B##...........................................................................BB
B##...........................................................................BB
B##...................................BBBB....................................BB
B##............BBBBBBBB.......................................................BB
B##...........................................................................BB
B##...BB......................................................................BB
B##..........H...........................MM...................................BB
B##.....................................................BBBBB.................BB
B##..............1.......BBB...........2.......B..............................BB
B##...LGR..............BBBBBBBBB..............BBBB............................BB
BGGGGGIIIGGGGGGGGGGGGGGGGGGGGGGGGGGGGGGGGGGGGGGGGGGGGGGGGGGGGGGGGGGGGGGGGGGGGGBB
BIIIIIIIIIIIIIIIIIIIIIIIIIIIIIIIIIIIIIIIIIIIIIIIIIIIIIIIIIIIIIIIIIIIIIIIIIIIIIBB
BIIIIIIIIIIIIIIIIIIIIIIIIIIIIIIIIIIIIIIIIIIIIIIIIIIIIIIIIIIIIIIIIIIIIIIIIIIIIIBB
