BBBBBBBBBBBBBBBBBBBBBBBBBBBBBBBBBBBBBBBBBBBBBBBBBBBBBBBBBBBBBBBBBBBBBBBBBBBBBBBBBBBBBBBBBBBBBBBBBBBBBBBBBBBBBBBBBBBBBBBB
B##...................................................................................................................BB
B##...................................................................................................................BB
B##...................................................................................................................BB
B##...................................................................................................................BB
B##...................................................................................................................BB
B##...................................................................................................................BB
B##...................................................................................................................BB
B##...................................................................................................................BB
B##...................................................................................................................BB
B##...................................................................................................................BB
B##...................................................................................................................BB
B##...................................................................................................................BB
B##...................................................................................................................BB
B##...................................................................................................................BB
B##...................................BBBB............................................................................BB
B##............BBBBBBBB...............................................................................................BB
B##...................................................................................................................BB
B##...BB..............................................................................................................BB
B##..........H...........................MM..............."..1..."....................................................BB
B##........................................................BBBBBB.....................................................BB
B##..............1.......BBB...........2.......B......................................................................BB
B##...LGR..............BBBBBBBBB..............BBBB....................................................................BB
BGGGGGIIIGGGGGGGGGGGGGGGGGGGGGGGGGGGGGGGGGGGGGGGGGGGGGGGGGGGGGGGGGGGGGGGGGGGGGGGGGGGGGGGGGGGGGGGGGGGGGGGGGGGGGGGGGGGGGBB
BIIIIIIIIIIIIIIIIIIIIIIIIIIIIIIIIIIIIIIIIIIIIIIIIIIIIIIIIIIIIIIIIIIIIIIIIIIIIIIIIIIIIIIIIIIIIIIIIIIIIIIIIIIIIIIIIIIIIIBB
BIIIIIIIIIIIIIIIIIIIIIIIIIIIIIIIIIIIIIIIIIIIIIIIIIIIIIIIIIIIIIIIIIIIIIIIIIIIIIIIIIIIIIIIIIIIIIIIIIIIIIIIIIIIIIIIIIIIIIBB
