BBBBBBBBBBBBBBBBBBBBBBBBBBBBBBBBBBBBBBBBBBBBBBBBBBBBBBBBBBBBBBBBBBBBBBBBBBBBBBBB
B.............................................................................BB
B.............................................................................BB
B.............................................................................BB
B.............................................................................BB
B.............................................................................BB
B.............................................................................BB
B.............................................................................BB
B.............................................................................BB
B.............................................................................BB
B.............................................................................BB
B.............................................................................BB
B.............................................................................BB
B.............................................................................BB
B.............................................................................BB
B.....................................BBBB....................................BB
B.............................................................................BB
B.............................................................................BB
B.....BB..........................BBBB........................................BB
B............H...MM...........................................................BB
B................................B......................BBBBB.................BB
B........................BBB...................B..............................BB
B.....LGR..............BBBBBBBBB..............BBBB............................BB
BGGGGGIIIGGGGGGGGGGGGGGGGGGGGGGGGGGGGGGGGGGGGGGGGGGGGGGGGGGGGGGGGGGGGGGGGGGGGGBB
BIIIIIIIIIIIIIIIIIIIIIIIIIIIIIIIIIIIIIIIIIIIIIIIIIIIIIIIIIIIIIIIIIIIIIIIIIIIIIBB
BIIIIIIIIIIIIIIIIIIIIIIIIIIIIIIIIIIIIIIIIIIIIIIIIIIIIIIIIIIIIIIIIIIIIIIIIIIIIIBB
